10 15
|------------|
|.....@.....F|
|.--.-.--.--.|
|P--.-....--.|
|.--......--.|
|...F....F...|
|.-.--.--.---|
|P-.--.--...P|
|------------|